########     #
#            #####
#                #
                 #
             #####
             #
             #
   #####     #
#      #
#      #
#            #
#            #
#            #
#            #
#
#      #
#
#
#
#
#
#
#
##
